1000000000000001
1000000000000001
1000000000000001
1111100000000001
1000000000000001
1000000000000001
1000000001111111
1000000000000001
1000000022000001
1000022222000001
1000022222000001
1111111111111111