00000000000000000000000050000000000000000000000000
00000000000000000000000050000000000000000000000000
00000000000000000000000050000000000000000000000000
00000000000000000000000050000000000000000000000000
00000000000000000000000050000000000000000000000000
00000003303303033333000050000000000000000000000000
00000330333333033300000050000000000000000000000000
00000030030333333033000050000000000000000000000000
00000333333333333333000050000000000000000000000000
00000333300333033033000050000444444444444000000000
00000333003003030303000050000422222222224000000000
00000330333000303033000050000422222222224000000000
00000033303303333303000050000422222222224000000000
00000303033303300000000050000422222222224000000000
00000303333333303033000050000422222222224000000000
00000333333330333303000050000422222222224000000000
00000000003303030333000050000422222222224000000000
00000330333330330003000050000422222222224000000000
00000003333033303303000050000444444444444000000000
00000303030303033333000050000000000000000000000000
00000000000000000000000050000000000000000000000000
00000000000000000000000050000000000000000000000000
00000000000000000000000050000000000000000000000000
00000000000000000000000050000000000000000000000000
00000000000000000000000050000000000000000000000000
55555555555555555555555555555555555555555555555555
00000000000000000000000050000000000000000000000000
00000000000000000000000050000000000000000000000000
00000000000000000000000050000000000000000000000000
00000000000000000000000050000000000000000000000000
00000000000000000000000050000000000000000000000000
00000000000000000000000050000000000000000000000000
00000000000000000000000050000000000000000000000000
00000000000000000000000050000000000000000000000000
00000000000000000000000050000000000000000000000000
00000000001111111000000050000000000000000000000000
00000000001111111000000050000000000000000000000000
00000000001111111000000050000000000000000000000000
00000000001111111000000050000000000000000000000000
00000000001111111000000050000000000000000000000000
00000000001111111000000050000000000000000000000000
00000000001111111000000050000000000000000000000000
00000000000000000000000050000000000000000000000000
00000000000000000000000050000000000000000000000000
00000000000000000000000050000000000000000000000000
00000000000000000000000050000000000000000000000000
00000000000000000000000050000000000000000000000000
00000000000000000000000050000000000000000000000000
00000000000000000000000050000000000000000000000000
00000000000000000000000050000000000000000000000000
